000000000000000000000000000000000000
011111111111100001000000110000011110
010000000000110001001111100000110010
010000000000100000001000000000000010
010000000100100000111001111111100010
010000000100111000000001700000100010
010000000100001000000001000001100010
010001111100001000001111000011000000
010001000000001000001000000000001000
010001000000111000001001111001111110
010001000100100000001111001111301000
010000000100100000000000000000001000
010000111100111000011111111111111000
010000003100001000010000000000000000
011111111100001111110000000000000000
000000000000000000000000111110010000
001111111110011111111100000011111000
001000000000001000000100000010000000
001110000111101000000100011110000000
200000000000000000000000000000000000