111111111111111111111111111100000001111111111111111111111111111111111111
000000011111110000001111100000000000000000000111110000001111111111111111
020000011111111111000000000001111110000000000111111111000111111111111111
000000000111111111000011111111111111100000000111111110000000001111111111
111001111111111110000004000111001111111111100111111110000004000111001111
111001111111111111100011100000001111111001111111111111100011100000001111
111000000000001111100011110011111100000000000000001111100011110011111111
111110000000400000000011111111111001111110000000400000000011111001111111
111111111100000000000011111111100011111111111100000000000001111000111111
111111110000000000011111111111000111111111110000000000011111111110011111
111111000111111111111111111100011111111111000111111111111111111110001111
111111100001111111111111111000111111111110000111111111111111111111000111
111111111000000111111111111001111111111110000001111111111111111111000111
111111111000000110000111111000111111111111111070000111111111111000011111
111111111110000000000111100000001111111111111110000000111111100000001111
111111111111111110000011110001111111111111111100000111111111111000011111
111111111111111111110000000000111111111111111110011111110000000000111111
111111111111111111110005000000111111111111111100011111110005000000111111
111111111111111111111111111110000000000000000000111111111111111100000111
111111111111111111111111111110000000000000011111111111111111100000001111
111111111111111000111111111111111111000000001111111111111100000001111111
111111111111110000001111111111111111000110000011111111100000111000011111
020000000111111111000111111111111111000110000000111111111000111100011111
000000000111111110000000001111111111000000000111111110000000001110001111
111111100111111110000004000111001111110001110011111110000111111111001111
111111100111111111100011100000000011110011100011111111100011111110000011
111111100000001111100011110011111000000111111000001111100011110000011111
111111100000400000000011111111111000111111100000400111000011111110001111
111111111100000000000011111111111100011111111100000000000011111100011111
111111110000000000011111111111111110001111100000001111110001111000111111
111111000111111111111111111111111110001111000111111111110011110001111111
111111100001111111111111111111111111100011100000111111000111100111111111
111111111000000111111111111001111111111001111000111111100011111111111111
111111111000000110000111111000111111111100011000000110000111111111110001
111111111110000000000111100000001111111110001111100000000111111000000011
111111111111111110000011110001111111111111100011111110000000011110001111
111111111111111111110000000000111111111111110011111111111111000000011111
111111111111111111110005000000000111111111000111111111110000000000111111
111111111111111111111111111110000000000000000111111110000005001111111111
111111111111111111111111111111111111111111111111111111111111111111111111