111111111111111111111111111111111111
000000000111110000001111111111111111
020000000111111111000111111111111111
000000000111111110000000001111111111
111111100111111110000004001111111111
111111100111111111100011111111111111
111111100000001111100011111111111111
111111100000400000000011111111111111
111111111100000000000011111111111111
111111111111100000011111111111111111
111111111111111111111111111111111111
111111111111111111111111111111111111
111111111111111111111111111111111111
111111111111111111111111111111111111
111111111111111111111111111111111111
111111111111111111111111111111111111
111111111111111111111111111111111111
111111111111111111111111111111111111
111111111111111111111111111111111111
111111111111111111111111111111111111