111111111111111111111111111111111111
111111111111100001000000110000011110
000000000000110001000111100000110010
200000000000000000030011110000000010
000000000100000000111001111111100010
111111111104011000000001700000100010
111111111100001100000001000001100010
110001111100001100001111000011000000
010001000000001100001000000000001000
010001000000111000001001111001111110
010001000100100000001111001111101000
010000000100100000000000000000001000
010000111100111000011111111111111000
010000003100001000010000000000000000
011111111100001111110000000000000000
000000000000000000000000111110010000
001111111110011111111100000011111000
001000000000001000000100000010000000
001110000111101000000100011110000000
000000000000000000000000000000000000