000000000000000000000000000000000000
011111111111100000000000000000000000
010000000000110000000001100000000000
010000000000100000000000000000000000
010000000100100000000001111111000000
010000000100111000000001700000000000
010000000100001000000001000000000000
010001111100001000001111000000000000
010001000000001000001000000000001000
010001000000111000001001111001111000
010001000100100000001111001111301000
010000000100100000000000000000001000
010000111100111000011111111111111000
010000003100001000010000000000000000
011111111100001111110000000000000000
000000000000000000000000000110010000
001111111110011111111100000011111000
000000000000000000000000000000000000
000000000000000000000000000000000000
000000000000000000000000000000000000