11111111111111111111111
11111111111111111111111
00000000000000000011111
02000000000000000011111
00000000000000000011111
11100000000000000011111
11100000007000000011111
11100000000000000011111
11100000000000000011111
11100000000000000011111
11100000000000000011111
11111111111111111111111
11111111111111111111111
