111111111111111111111111111111111111111111111111111111111111111111111111
000000011111110000001111100000000000040FFF000111110000001111111111111111
02000001111110000000000000000111111000BAAAD00111111111000111111111111111
000000000111111111000011111111111111100KAAD001111111100000000011111AA111
1110011111111111100000040001110011111111DD100111111110000004000111AAA111
111001111111111111100011100000001111111001111111111111100011100000KAA111
1110000000000011111000111100011111000000000000000011111000111100111AA111
111110000000400000000011111000111001111110000000400000000011111001111111
111111111100000000000011111111100011111111111100000000000001111000111111
111111100000000000011111111111000111111111110000000000011111111110011111
111111000111111111111111111100001111111111000111111111111111111110001111
111111100001111111111111111000011111111110000111111111111111111111000111
111111111000000111111111111000111111111110000001111111111111111111000111
11111111100000011000011111100BAA1111111111111070000111111111111000011111
11111111111000000003011110000GAAA111111111111110000000111111100000001111
1111111111111111100000111100GAAA1111111111111100000111111111111000011111
11111111111111111111000000000J111111111111111110011111110000000000111111
111111111111111111110005000000111111111111111100011111110005000000111111
111111111111111111111111111110000000000000000000111111111111111100000111
111111111111111AAA111111111110000000000000011111111111111111100000001111
11111111111111AAAAA11111111111111111000000001111111111111100000001111111
11111111111111KLKLJ01111111111111111000110000011111111100000111000011111
100000000111111111000111111111111111000110000000111111111000111100011111
100000000111111110000000001111111111000000000111111110000000001110001111
111111100111111110000004000111001111110001110011111110000111111111001111
111111100111111111100011100000000011110011100011111111100011111110000011
111111100000001111100011110011111000000111111000001111100011110000011111
11111110000040000JJ00011111111111000111111100000400111000011111110001111
1111111111000000GAAH0011111111111100011111111100000000000011111100011111
111111110000000GAAAA111111111111111H001111100000001111110001111000111111
111111000111111A111111111111111111AAH01111000111111111110011110001111111
111111100001111111111111111A1111111AL00011100000111111000111100111111111
11111111100000011111111111AAAA11111110000111100011111110001111111111AAA1
11111111100000011000011111AAAL1111111000000110000001100001111111111AAAAA
11111111111000000000011110KAL00011111111100011111000000001111110000KAAA1
111111111111111110000011110J01111111111110000011111110000000011110001111
111111111111111111110000000000111111111111100011111111111111000000011111
111111111111111111110005000000000111111111000111111111110000000000111111
111111111111111111111111111110000000000000000111111110000005001111111111
111111111111111111111111111111111111111111111111111111111111111111111111