111111111111111111111111111111111111111111111111
020000000000000300000001111111110000000111111111
100000111100000001110000011111000000000000111111
110000111110000001111100000800000111110004011111
111100000000040000111100000000000111110000001111
111111000000110000000000011111111111110000001111
111111000001111110000000111111111111111000000111
111110000011111111000000111111111111111000000011
111110000011111111000000000000000000000000000011
111111000000000000000000000000000000003000000011
111111005000000000011111111111111110000000000111
111110000000111100011111111111111111000000000111
111100000001111100011111111111111111100000000011
111100000001111100011111111111111111100000000011
111100800001111100000000011111111111110005001111
111000000011110000000000001111111111110000001111
111000000011100001111000050001111111100000001111
111000000000000011111110000001111110000000000011
110000000000001111111110000000000000000011110011
110000001111111111111111100000000000000011110001
110000011111111111111111100000011111111111110001
110000011111111111111111000000111111111111110001
100000111111111111111110000001111111111111110011
100000111111111100000000000001111111111111110411
100000000050000000000000000000000000001111110001
000000000000000001111111111100000000000701110001
000011111000000001111111111110000000000000000001
004011111100000000003000000000000011111100000001
100111111110000000000000000111111111111111100001
111111111111111111111111111111111111111111111111