RRRRRU0000000000QRRRKKKKKU000000000000000000QKKKKKKKKKKKKRRRRRRRRRRRRKKK
02000000000000000000QRRRU000000000000AE000000QKKKKKKKKKKU000000000000IKK
00000000YBBBBBE00000000000000000000ABKKE000000QRKKKKKKKU000000000000AKKK
E000000000QRRRU0000000000000000000AKKKKKBBE00000IKKKKKU000000ABBE00AKKKK
KE000000000000000000ABBBBBBBBE000AKKKKKKKKKE0000QRRRRU0000000IKKM00QKKKK
KM0000000000000000ABKKKKKKKKKM000QKKKKKKKKKU00000000000AE0000IKKM000QKKK
KM000000ABBBE00000QRRRKKKKKKKKE000QKKKKRRRU0000ABBBBBBBKKE000IKKKE000IKK
KU0000ABKKKKM000000000QRKKKKKKM0000IKKU00000000QRRRRRRRRKM000IKKKM000IKK
M00000IKKKKKU00000000000QRKKKKM0000QRU000000000000000000QU000IKKKM000IKK
M00000QRRRRU0000ABBBE00000IKKKKE000000000000000ABBBBBBE00000AKKKKM000IKK
U000000000000000IKKKKE0000IKKKKM000000ABBBE0000QRRRRRRU00000IKKKKU00AKKK
000000000000000AKKKKKU0000QKKKKKBE0000QKKKM00000000000000ABBKKKKU000IKKK
000ABBBBBBBBE00IKKKKM000000QRRRRRRX0000IKKM000ABBBBE000ABKKKKKKM0000IKKK
000IKKKKKKKKM00QRRRRU000000000000000000IKKM000IKKKKM000QRRRRRRRU0000IKKK
000QKKKKKKKKM0000000000000000000000000AKKKM000IKKKKM0000000000000000IKKK
E000IKKKKKKKKE00000000ABBBBBBBE0000ABBKKKKKE00QKKKKKE00000000000000AKKKK
U000IKKKKKKKKU0000ABBBKKKKKKKKU0000IKKKKKKKM000IKKKKM000YBBBBBBE000IKKKK
0000QRRRRRRRU00000IKKKKKKKKKKM0000AKKKKKKKKM000IKKRRU0000IKKKKKU000QKKKK
00000000000000000AKKKKKKKKKKKM0000QKKKKKKKKKBBBKKU0000000IKKKKM00000IKKK
0000000000000ABBBKKKKKKKKKKKKKE0000IKKKKKKKKKRRRU00000000IKKKKM00000IKKK
00ABBE000YBBBKKKRRRRRRRRRKKKKKM0000QRKKKKKKKM0000000000ABKKKKKKE000AKKKK
0AKKKU0000QRRRRU000000000QRRKKKBE0000QKKKKKKU00000000ABKKKKKKKKKE00IKKKK
0QKKU00000000000000000000000IKKKM00000QRRRRU000ABBBBBKKKKKKKKKKKU0AKKKKK
00QU0000AE0000000ABBBBBBE000QKKKKE000000000000AKKKKKKKKRRRRRRRRU00QRRRKK
E000000AKKBBE0000IKKKKKKM0000IKKKM000000000000IKKKKKKKM000000000000000QK
M00000AKKKKKM0000IKKKKKKKBE00IKKKKE00000000ABBKKKKKKKKU00000000AE000000I
U00000IKKKKKM0000QKKKKKKKKKBBKKKKKM0000000AKKKKKKKKKKM00000000AKKE00000I
00000AKKKKKKKE0000IKKKKKKKKRRKKKKKKE000000IKKKKKKKKKKM0000000AKKKKE0000I
0000AKKKKKKKKM0000QRRRRRRRU00QRRRRRU000000QRRRRRRKKKKKBBBBBBBKKRRRU0000I
E000QKKKKKKKKU00000000000000000000000000000000000QRRRRRRRRRRRRU0000000AK
M0000QRRRRRRU00000000000000000000000000000000000000000000000000000000AKK
M0000000000000000ABBBBBBBE000000ABBBBBBBBBBE000000000000000000ABBBE00QKK
M000000ABBBBE0000IKKKKKKKKE0000AKKKKKKKKKKKU000000ABBBBBE000ABKKKKM000QK
KE00000IKKKKKE000IKKKKKKKKM0000IKKKKKKKKKKM000000AKKKKKKM000IKKKKKKE000I
RU0000AKKKKKKM00AKKKKKKKKKKE00AKKKKKKKKKKKM0070ABKKKKKKKM00AKKKKKKKM000I
0000ABKKKKKKKM00IKKKKKKKKKKKBBKKKKKKKKKKKKU0000QKKKKKRRRU00QRRRRKKKKE00I
0000QRRRRRRRRU00QRRKKRRRRRRRRRRRRRRRRRRRRU000000QRRRU00000000000QRRRKBBK
0000000000000000000QU00000000000000000000000AE0000000000000000000000IKKK
BBBE00000000000000000000000000000000000000ABKKE0000000000ABBBE000000IKKK
KKKKBBBBBBBBBBBBBBBBBBBBBBBBBBBBBBBBBBBBBBKKKKKBBBBBBBBBBKKKKKBBBBBBKKKK