111111111111111111111111111111111111
000000080111110800001111111111111111
020000000111111111000111111111111111
000000000111111110000000001111111111
111111100111111110000004001111111111
111111100111111111100011111111111111
111111100000001111100011111111111111
111111100000400000000011111001111111
111111111100000000000000000011111111
111111110000000000011111100011111111
111111000111111111111111100011111111
111111100001111111111110000011111111
111111111000000111111111100001111111
111111111000000110000111111000111111
111111111110000000000111100000001111
111111111111111110000011117001111111
111111111111111111110000000000111111
111111111111111111110005000000001111
111111111111111111111100000000111111
111111111111111111111111111111111111