111111111BEEEEEEEEEEEEEEAAAAAAAAAAAAD11111111111
020000000GEEEEAIEEEEEEEEEEEEEEEEEEEED00111111111
10000011BEEEEEEEEEAAAAAEEEEAAAAAAAAL000000111111
110000111BAAAAEEEEEEEEEEEEEEEEEEEEL1110000011111
1111000000JJJKEEEEEEAAEEEEEEEAAAAAD1110000001111
11111100000011JKEEEEEEEEEE1111111111110000001111
1111110000011111JJJJJKAIA11111111111111000000111
1111100000111111110000JJJ11111111111111000000011
111110000011111111000000000000000000000000000011
111111000000000000000000000000000000000000000011
111111000000000000011111111111111110000000000111
1111FFFFFFFFF11100011111111111111111000000000111
111EEEEEEEEEE11100011111111111111111100000000011
111EEEAAEEEEE11100011111111111111111100000000011
111EEEEEIEEEE11100000000011111111111110000001111
11EEAAAAAAA11B0000000000001111111111110000001111
11JJJJKEEEEEEB0001111000000001111111100000001111
1110000KAAAAEB0011111110000001111110000000000011
11000000JJJJJ01111111110000000000000000011110011
110000001111111111111111100000000000000011110001
110000011111111111111111100000011111111111110001
110000011111111111111111000000111111111111110001
100000111111111111111110000001111111111111110011
100000111111111100000000000001111111111111110011
100000000000000000000000000000000000001111110001
000000000000000001111111111100000000000701110001
000011111000000001111111111110000000000000000001
000011111100000000000000000000000011111100000001
100111111110000000000000000111111111111111100001
111111111111111111111111111111111111111111111111