111111000000000011111111110KAAAAAAH0000000001111111111111111111111111111
0200000000000000000011111000KAAAAAAH011000000111111111111000000000000111
00000000111111100000000000000KAAAAAA111100000011111111110000000000001111
100000000KAAAA1000000000000000KAAAA1111111100000111111100000011110011111
110000000GAAAL00000011111111110KAA11111111110000111111000000011110011111
11000000GAAAL0000011111111111100KA11111111110000000000011000011110001111
11000000A11A100000111111111111100011111111100001111111111100011111000111
110000111111100000000011111111100001111000000001111111111100011111000111
100000111111100000000000111111100001110000000000000300001100011111000111
100000AAAAAA000011111000001111110000000000000001111111100000111111000111
100000KAAAAL000011111100001111110000001111100001111111100000111111001111
0000000JJJJ00001111111000011111111000011111000000000000001111111AHFF1111
0001111111111001111110000001111111100001111000111111000111111111AAAA1111
0001111111111001111110000000000000000001111000111111000111111111AAAAA111
0001111111111000000000000000000000000011111000111111000000000000KAAAA111
10001111111111000000001111111110000111111111001111111000000000000KAA1111
100011111111110000111111111111100001111111110001111110001111111100KA1111
0000111111111000001111111111110000111111111100011111100GC111111100011111
000000000000000001111111111111000011111111111111110000GAAAA1111000001111
00000000000001111111111111111110000111111111111110000GAAAA11111000001111
0011110001111111111111111111111000011111111110000000BAAAA111111100011111
011111000011111100000000011111111000011111111000000001111111111110011111
011110000000000000000000000GA1111000001111110001111111111111111110111111
00110000110000000111111110GA11111100000000000011111111111111111100111111
1000000111111000011111111GAAA1111100000000000011111111100000000000000011
1000001111111000011111111AAAA1111110000000011111111111AH0000000110000001
100000111111100001111111111AA111111000000011111111111AAAH000001111000001
000001111111110000111111111AA111111100000011111111111AAAAH00011111100001
00001111111111000011111111AAA1111111000000111111111111111111111111100001
10001111111111000000000000KAAD000000000000000000011111111111111000000011
10000111111110000000000000GAAD000000000000000000000000000000000000000111
10000000000000000111111111AAAH001111111111110000000000000000001111100111
10000001111110000111111111AAAAH11111111111110000001111111000111111100011
11000001111111000111111111AAAAAA1111111111100000011111111000111111110001
110000111111110011111111111AAAA11111111111100701111111111001111111110001
000011111111110011111111111111111111111111100001111111111001111111111001
000011111111110011111111111111111111111111000000111110000000000011111111
000000000000000000011000000000000000000000001100000000000000000000001111
111100000000000000000000000000000000000000111110000000000111110000001111
111111111111111111111111111111111111111111111111111111111111111111111111