1111111111100000000011111EEEEEEEE111111111111111
02000000000011110000000BEEEEEEEE1111111111111111
00000111111111111111100BEEEEEEEEEEEEE11111111111
10001BEEEEEED00000001100KEEEEEEEEEEEE11111111111
10000BEEEEEED00000000000111111111111111111000011
11000BEEEEEED11111111100000011111111111000011001
11100BEEEEEL011111111111110000111111110001111001
111000111110011111111111000100000111000111111001
110001111111000111111110001111100000001111111001
100011111111100011111100011111111000111111111001
100111111111110001111001111111111111111111111001
100111111111100000000011111111111111111111110011
10011111111000F01111FFFFFFFFEE111111111111000111
100011111000FGE1111111EEEEEEEEEE111111EEFFFFF111
11000111000GEEEE111111EEEEEEEEEEEEEEEEEEAAAAA111
1110000000111EEEEEE11111EEEEEEEEEEEEAAAAAA111111
11110000011111EEEEE11111EEEEAAAAAAAEEEEEEE111111
11110000111111EEEEE111111111111111EEEEAAAA111111
111000011111111111111111111111EEEEEEEEEE11111111
11000000FFFFFEE11111111111111EEEEEAIEE1111111111
FFFFFF111EEEEEEE11111111111111EEEEEE111111111111
EEEEE111111AAEEEEE111111111100KEEE11111111111111
AAAAA11111111EEAAAAE1111100000BE111111EEEEEEEEEE
AAAA11111111111EEEEEED100001111111111EEEEEEEEEEE
EEIEE111111111111EEEED00011111111111EEEEEEEEEEEE
EEEEEEE1111111111JJJJ0111111111111EEEEEEEEEEEEEE
111JJJJ1111111110000000001111111EEEEEEEEEEEEEEEE
11110001111111000011110000000011JJJJKEEEEEEEEEEE
111110000000000011111111110000000000111111111111
111111111000011111111111111111000111111111111111