KKKKKK0000000000KKKKKKKKKK000000000000000000KKKKKKKKKKKKKKKKKKKKKKKKKKKK
02000000000000000000KKKKK000000000000KK000000KKKKKKKKKKKK000000000000KKK
00000000KKKKKKK00000000000000000000KKKKK000000KKKKKKKKKK000000000000KKKK
K000000000KKKKK0000000000000000000KKKKKKKKK00000KKKKKKK000000KKKK00KKKKK
KK000000000000000000KKKKKKKKKK000KKKKKKKKKKK0000KKKKKK0000000KKKK00KKKKK
KK0000000000000000KKKKKKKKKKKK000KKKKKKKKKKK00000000000KK0000KKKK000KKKK
KK000000KKKKK00000KKKKKKKKKKKKK000KKKKKKKKK0000KKKKKKKKKKK000KKKKK000KKK
KK0000KKKKKKK000000000KKKKKKKKK0000KKKK00000000KKKKKKKKKKK000KKKKK000KKK
K00000KKKKKKK00000000000KKKKKKK0000KKK000000000000000000KK000KKKKK000KKK
K00000KKKKKK0000KKKKK00000KKKKKK000000000000000KKKKKKKK00000KKKKKK000KKK
K000000000000000KKKKKK0000KKKKKK000000KKKKK0000KKKKKKKK00000KKKKKK00KKKK
000000000000000KKKKKKK0000KKKKKKKK0000KKKKK00000000000000KKKKKKKK000KKKK
000KKKKKKKKKK00KKKKKK000000KKKKKKKK0000KKKK000KKKKKK000KKKKKKKKK0000KKKK
000KKKKKKKKKK00KKKKKK000000000000000000KKKK000KKKKKK000KKKKKKKKK0000KKKK
000KKKKKKKKKK0000000000000000000000000KKKKK000KKKKKK0000000000000000KKKK
K000KKKKKKKKKK00000000KKKKKKKKK0000KKKKKKKKK00KKKKKKK00000000000000KKKKK
K000KKKKKKKKKK0000KKKKKKKKKKKKK0000KKKKKKKKK000KKKKKK000KKKKKKKK000KKKKK
0000KKKKKKKKK00000KKKKKKKKKKKK0000KKKKKKKKKK000KKKKKK0000KKKKKKK000KKKKK
00000000000000000KKKKKKKKKKKKK0000KKKKKKKKKKKKKKKK0000000KKKKKK00000KKKK
0000000000000KKKKKKKKKKKKKKKKKK0000KKKKKKKKKKKKKK00000000KKKKKK00000KKKK
00KKKK000KKKKKKKKKKKKKKKKKKKKKK0000KKKKKKKKKK0000000000KKKKKKKKK000KKKKK
0KKKKK0000KKKKKK000000000KKKKKKKK0000KKKKKKKK00000000KKKKKKKKKKKK00KKKKK
0KKKK00000000000000000000000KKKKK00000KKKKKK000KKKKKKKKKKKKKKKKKK0KKKKKK
00KK0000KK0000000KKKKKKKK000KKKKKK000000000000KKKKKKKKKKKKKKKKKK00KKKKKK
K000000KKKKKK0000KKKKKKKK0000KKKKK000000000000KKKKKKKKK000000000000000KK
K00000KKKKKKK0000KKKKKKKKKK00KKKKKK00000000KKKKKKKKKKKK00000000KK000000K
K00000KKKKKKK0000KKKKKKKKKKKKKKKKKK0000000KKKKKKKKKKKK00000000KKKK00000K
00000KKKKKKKKK0000KKKKKKKKKKKKKKKKKK000000KKKKKKKKKKKK0000000KKKKKK0000K
0000KKKKKKKKKK0000KKKKKKKKK00KKKKKKK000000KKKKKKKKKKKKKKKKKKKKKKKKK0000K
K000KKKKKKKKKK00000000000000000000000000000000000KKKKKKKKKKKKKK0000000KK
K0000KKKKKKKK00000000000000000000000000000000000000000000000000000000KKK
K0000000000000000KKKKKKKKK000000KKKKKKKKKKKK000000000000000000KKKKK00KKK
K000000KKKKKK0000KKKKKKKKKK0000KKKKKKKKKKKKK000000KKKKKKK000KKKKKKK000KK
KK00000KKKKKKK000KKKKKKKKKK0000KKKKKKKKKKKK000000KKKKKKKK000KKKKKKKK000K
KK0000KKKKKKKK00KKKKKKKKKKKK00KKKKKKKKKKKKK0070KKKKKKKKKK00KKKKKKKKK000K
0000KKKKKKKKKK00KKKKKKKKKKKKKKKKKKKKKKKKKKK0000KKKKKKKKKK00KKKKKKKKKK00K
0000KKKKKKKKKK00KKKKKKKKKKKKKKKKKKKKKKKKKK000000KKKKK00000000000KKKKKKKK
0000000000000000000KK00000000000000000000000KK0000000000000000000000KKKK
KKKK00000000000000000000000000000000000000KKKKK0000000000KKKKK000000KKKK
KKKKKKKKKKKKKKKKKKKKKKKKKKKKKKKKKKKKKKKKKKKKKKKKKKKKKKKKKKKKKKKKKKKKKKKK