RRRRRRRRRGKKKFRRRRRRGKKKKKKKKKKKKKKK
000000000IKKKM000000QGKKKKKKKKKKKKKK
020008000IKKKNBBBX000QRRRRGKKKKKKKKK
000000000IKKKKKKM000000000IKKKKKKKKK
BBBBBBE00IKKKKKKM000000400IKKKKKKKKK
KKKKKKM00QRRRRGKNBE000ABBBOKKKKKKKKK
KKKKKKM0000000QRRRU000IKKKFRRGKKKKKK
KKKKKKM000004000000000QRRRU00IKKKKKK
KKKKKKNBZX000000000000000000AOKKKKKK
KKKKKFRU00000000000ABBBBE000IKKKKKKK
KKKKKM000YZBBBBBBBBOKKFRU000IKKKKKKK
KKKKKNE0000QRRRGKKKKKKM00000QGKKKKKK
KKKKKKNBE000000IFRRRRGNBE0000QGKKKKK
KKKKKKKKM000000QU0000IKKLZX000QRGKKK
KKKKKKKKNBE0000000000QGKM0000000IKKK
KKKKKKKKKKNBBBBBE00000QRRX700YBBOKKK
KKKKKKKKKKKKKKKKNBBE0000000000QRGKKK
KKKKKKKKKKKKKKKKKKKM000500000000IKKK
KKKKKKKKKKKKKKKKKKKNBE00000000ABOKKK
KKKKKKKKKKKKKKKKKKKKKNBBBBBBBBOKKKKK