111111000000000011111111110000000000000000001111111111111111111111111111
020000000000000000001111100000000000011000000111111111111000000006000111
000000001111111000000003000000000001111100000011111111110000000000001111
100000000011111000000000000000000011111111100000111111100000011110011111
110000000000000000001111111111000111111111110000111111000000011110011111
110000000000000000111111111111000111111111110000000000011000011110001111
110000001111100000111111111111100011111111100001111111111100011111000111
110000111111100000000011111111100001111000000001111111111100011111000111
100000111111100000000000111111100001110000000000000000001100011111000111
100000111111000011111000001111110000000000000001111111100000111111000111
100000008000000011111100001111110000001111100001111111100000111111001111
000000000000000111111100001111111100001111100000000000000111111110001111
000111111111100111111000000111111110000111100011111100011111111100001111
003111111111100111111000000000400000000111100011111100011111111100001111
000111111111100000000000000000000000001111100011111100000000000000001111
100011111111110000000011111111100001111111110011111110000000000000011111
100011111111110000111111111111100001111111110001111110001111111100011111
000011111111100000111111111111000011111111110001111110000111111100011111
000000004000000001111111111111000011111111111111110000000111111000001111
000000000000011111111111111111100001111111111111100000000111111000001111
001111000111111111111111111111100001111111111000000000011111111100011111
011111000011111100000000011111111000011111111000000001111111111110011111
011110000000000000000000000011111000001111110001111111111111111110111111
001100001100000001111111100011111100000000000011111111111111111100111111
100000011111100001111111100001111100000000000011111111100000000000000411
100000111111100001111111111601111110000300011111111111100000000110000001
100000111111100001111111111111111110000000111111111111000000001111000001
000001111111110000111111111111111111000000111111111111600000011111100001
000011111111110005111111111001111111000000111111111111111111111111100001
100011111111110000000000000000000000000000000000011111111111111000000011
100001111111100000000000000000000000000000000000000000000000000000000111
100000000000000001111111110000001111111111110000000000000000001111100111
100000011111100001111111111000011111111111110000001111111000111111100011
110050011111110001111111111006011111111111100000011111111004111111110001
110000111111110011111111111100111111111111100701111111111001111111110001
000011111111110011111111111111111111111111100001111111111001111111111001
000011111111110011111111111111111111111111000000111110000000000011111111
000000000000000000011000000000000000000000001100000000000000000000001111
111100000000005000000000000000000000000000111110000000000111110000001111
111111111111111111111111111111111111111111111111111111111111111111111111