111111111111111111111111111111111111
000111111111110000001111110000000001
020011111110000111000111100011111001
000000001111111110000100000111110011
110011100111111110000000001111100111
110011100111111111100011111111000111
100111110000111111100711111100001111
100111110000011111100011111001111111
100000111100000000000000000011111111
001100110000000000011111100011111111
001110011111111111111111100011111111
001111000011111111111100000111111111
100111111000000111111111100001111111
100111111000000110000111111000111111
110011111110000000000111110000111111
110011111111111110000011111001111111
110001111111111111110000000000111111
111000111100001111111000000000000111
111100000000011111111100000000111111
111111111111111111111111111111111111