111111111BEEEEEEEEEEEEEEAAAAAAAAAAAAD11111111111
020000000GEEEEAIEEEEEEEEEEEEEEEEEEEED00111111111
10000011BEEEEEEEEEAAAAAEEEEAAAAAAAAL000000111111
110000111BAAAAEEEEEEEEEEEEEEEEEEEEL1110000011111
1111000000JJJKEEEEEEAAEEEEEEEAAAAAD1110000001111
11111100000011JKEEEEEEEEEE1111111111110000001111
1111110000011111JJJJJKAIA11111111111111000000111
1111100000111111110000JJJ11111111111111000000011
111110000011111111000000000000000000000000FFFFA1
11111100000000000000000000000000000000000GAAAAA1
1111110000000000000111111111111111100000BAIAAAA1
1111FFFFFFFFF1110001111111111111111100000KAAAAA1
111EEEEEEEEEE11100011111111111111111100000KAAAA1
111EEEAAEEEEE111000111111111111111111000000JJKA1
111EEEEEIEEEE11100000000011111111111110000001111
11EEAAAAAAA11D0000000000001111111111110000001111
11JJJJKEEEEEED0001111000000001111111100000001111
1110000KAAAAED00111111AHF00001111110000000000011
11000000JJJJJ011111111AAAHGH00000000000011110011
11000000111111111111111AAAIAD0000000000011110001
11000001111111111111111AAAAL00011111111111110001
11000001111111111111111AAAL000111111111111110001
10000011111111111111111JJJ0001111111111111110011
1000FF1111111111000000000000011AAAA1111111110011
100GAAH000000000000000000000000KAAL0001111110001
00BAAAAH000000000111111111110000KL00000701110001
00BAAAAA10000000011111111111100000F0000000000001
00BAAA111100000000000000000000000GA1111100000001
100111111110000000000000000111111A11111111100001
111111111111111111111111111111111111111111111111