RRRRRRRRRRU000000000QRRKKRRRRRRKKKKKKKKKKKKKKKKK
020000000000ABBE0000000QU000000QKKKKKKKKKKKKKKKK
00000ABBBBBBKRRRVVVVE00000AE0000QRRKKKKKKKKKKKKK
E000YRRRRRRRU0000000QX000AKKBBE0000IKKKKKKRRRRKK
M00000000000000000000000YRRRKKKBBBBKKKKRRU0000QK
KE00000000000ABBBBBBBE000000QRKKKKKKKKU0000AE00I
KKE000ABBBE00IKKKKKKKKBBVX0000QRRKKKRU000ABKM00A
KKU000IKKKM00QRKKKKKKKKU000E00000QRU000ABKKKM00I
KU000AKKKKKE000QKKKKKKU000AKBBE0000000AKKKKKM00I
M000AKKKKKKKE000QKKKKU000AKKKKKBE000ABKKKKKKM00I
M00AKKKKKKKKKM000QRRU00ABKKKKKKKKBBBKKKKKKKKU00I
M00IKKKKKKKRU000000000QRRRRKKKKKKKKKKKKKKKRU00AK
M00IKKKKKRU00000ABBBE000000QRKKKKKKKKKKKKU000AKK
M000QKKKU00000YBKKKKKBE000000QRKKKKKKKKRU000AKKK
KE000QRU0000000QKKKKKKKE0000000QRRRKKKU0000AKKKK
KKE0000000ABE000QRKKKKKKBE000070000QRU000ABKKKKK
KKKE00000AKKKBE000IKKKKKKKBBBBE00000000ABKKKKKKK
KKKU0000AKKKKKKBBBKKKKKKKKKKKKKBBBBX0000IKKKKKKK
KKU0000YRRRRKKKKKKKKKKKKKKKKKKKKKRU0000AKKKKKKKK
KU0000000000QRKKKKKKKKKKKKKKKKKRU0000ABKKKKKKKKK
M0000ABBBE0000QRKKKKKKKKKKKKRRU0000ABKKKKKKKKKKK
M000AKKKKKBE0000QRKKKKKKKRRU00000ABKKKKKKKKKKKKK
M00AKKKKKKKKBE0000QRKKKRU000000ABKKKKKKKKKRRRRRK
M00QKKKKKKKKKKBE0000QRU0000ABBBKKKKKKKKRRU00000I
M000QKKKKKKKKKKKBE0000000ABKKKKKKKKKKRU00000000I
KE000QKKKKKKKKKKRRX000YVVKKKKKKKKKKRU000000000AK
KKBE00QKKKKKKKRU000000000QRRRRKKKRU0000000000AKK
KKKM000QRRRRRU0000ABBE00000000QRU000000000ABBKKK
KKKKE00000000000ABKKKKBBBE0000000000ABBBBBKKKKKK
KKKKKBBBE0000ABBKKKKKKKKKKBBBE000ABBKKKKKKKKKKKK