AL1BAAAAAA111EEEEEL11111111111111111
AL0BAAAAAA111EEAAED01111111111111111
AD0BAAAAAA111EEEEAD00111111111111111
AH0GAAALJJ111111JJ000000001111111111
AH1KAAAD0111111110000GACAE1111111111
11111110011BAEE1111DBIAAEE1111111111
11111110000BAAEAEEAD0K11111111111111
11111110000BIEEEEAEH0011111001111111
111111111100JJJKEAAEH000000011111111
111111110GCCH000JKAAE111100011111111
11111100BAEEE11111111111100011111111
111111100KAEAAEE1111111000001EE11111
1111111110KAEEAAAAED11111000BEAE1111
11111111100JKEEAAAED0111CCCCCAEA1111
1111111111100JJKAEED0111EEEEEAAEE111
1111111111111111JJJ000111EIEEA111111
1111111111111111111100000KAELKEEE111
11111111111111111111000500JJ0BEEE111
1111111111111111111111000000001EE111
111111111111111111111111111111111111