111111111110000000001111111111111111111111111111
020000000400111100000001100000011111111111111111
000001111111111111111000001100001111111111111111
100011111111100000001100011111100001111111111111
100000080000000000000000111111111111111111000011
110000000000011111111100000011111111111000011001
111000111110011111111111110000111111110001111001
111000111110011111111111000100000111000111111001
110001111111000111111110001111100000001111111001
100011111111100011111100011111111000111111111001
100111111111110001111001111111111111111111111001
100111111111100000000011111111111111111111110011
100111111110000011111000000111111111111111000111
100011111000001111111110005001111111111110001111
110001110000000111111111000000011111111000011111
111000040011100011111111110000700001110001111111
111100000111111000111111111111100000000111111111
111100001111111111111111111111111111000011111111
111000011111111111111111111111111110000111111111
110000000000111111111111111111111000011111111111
100001111100001111111111111111100001111111111111
103011111111000011111111111100000111111111111111
100111111111110000111111100000011111111111111111
100111111111111100001110000111111111111111000001
100011111111111111000000011111111111111000000001
110001111111111111104011111111111111100000300011
111100111111111100000000011111111110000000000111
111100011111110000111100000000111000000000111111
111110000000000011111111110000000000111111111111
111111111000011111111111111111000111111111111111