RRRKKKKKKKKKKKRRRRRRKKKKKKRRRRRRRRRQ
000QKKKKKKKRRU000000QKKKKU000000000I
0200QRRRKKM0000ABX000IRRU000ACCCX00I
00000000QKKBBBBKM0000S00000AKKKU00AK
BE00ABE00IKKKKKKM000000000AKKKU00AKK
FU00IKM00QRRGKKKKBE000ABBBKKRU000IKK
M00AKKKE0000QKKKKKM007IKKKKU0000AKKK
M00QRRKM00000QRRRRU000QRRRU00ABBKKKK
U00000IKRX000000000000000000AKKKKKKK
00AE00QM00000000000ABBBBE000IKKKKKKK
00IKE00QRRBBBBBBBBBKKKRRU000IKKKKKKK
00QKKE0000QRRRRKKKKKKM00000QRKKKKKKK
E00IKKBBE000000IKRRRRKBBE0000QKKKKKK
M00QKKKKM000000QU0000IKKKBX000IKKKKK
KE00IKKKKBE0000000000QKKKM0000IKKKKK
KM00QKKKKKKBBBBBE00000QRRRU00IKKKKKK
KM000QKKKKRRRRKKKBBE0000000000QRRKKK
KKE000QRRU0000IKKKKKE000000000000IKK
KKNE000000000AKKKKKKKE00000000ABBKKK
KKKKBBBBBBBBBKKKKKKKKNBBBBBBBBOKKKKK