1111111111111EEEEEEEEE11111111111111
0001111111EEEAAIEEEEAA11110000000001
0200111111EEEEEEAAAAAL11100011111001
00000000111EEEEEJJJJJ000000111110011
1100111001111111100000F0001111100111
110011100111111111100BE1111111000111
1001111100FGE11111FFFGE1111EH0001111
1001111FFGEEEEEEEEAEEEEEEEEEEA111111
1000001EEEEEEEEEEEAAEEEEEEEEA1111111
0011001AAAEEEEEAAEAE11111KAAA1111111
00111001111111111111111110KAA1111111
001111000011111111111100000JJ1111111
100111111000000111111111100001111111
1FFG11111000000110000111111000111111
1EEEE1111110000000000B11110000111111
1EEAE1111111111110000BEEAE1001111111
1EEAAAAAEEEEEEE1111FFGAAEE0000111111
11AEIAEEEEEEEEE11111AAAEAA0000000111
111EEEEEAAAAEE1111111EEAEE0000111111
11111111111111111111111AAA1111111111