RRRRRRRGKKKKKFRRRRRRGKKKFRRRRRRRRRRRRRRRRRRRRGKKKFRRRRRRGKKKKKKKKKKKKKKK
0000000IKKKKFU000000QRRRU00000000000040000000IKKKM000000QGKKKKKKKKKKKKKK
0200000QRGKKM0000000000000000ABBBBE0000080000IKKKNBBBX000QRRRRGKKKKKKKKK
000000000IKKNBBBBX0000YVVVVBBORRGKNRE00000000IKKKKKKM000000000QGKFRRGKKK
BBE00ABBBOKKKKKKM0000004000QRU00IKKKNBBVVBE00IKKKKKKM0000004000QRU08IKKK
KKM00QRRRRRRRRGKNBE000ABE0000000IFRRRRU00QRVVRRRRRGKNBE000ABE0000000IKKK
KKM00000000000QRRRU000IKNE000YBBOU0000000000000000QRRRU000IKNE00YBBBOKKK
KKNBE00000004000000000IKKNE000IRU00ABBBBE00000004000000000QGKNE00QGKKKKK
KKKKNBBVVX000000000000IKKKNBBBU000AOKKKKNBBBVX0000000000000IKKM000QGKKKK
KKKKKFU000000000000ABBOKKKKFRU000AOKKKKKKFRU00000000000ABBBOKKNBE00QGKKK
KKKKKM000YVBBBBBBBBOKKKKKKFU0000AOKKKKKKFU000ABBBBBBBBBOKKKKKKKKM000QGKK
KKKKKNE0000QRRRGKKKKKKKKKKM0000AOKKKKKKKM0000QRGKKKKKKKKKKKKKKKKNE000IKK
KKKKKKNBE000000IFRRRRGKKKKM000AOKKKKKKKKM000000QRRRGKKKKKKKKKKFRRU000IKK
KKKKKKKKM000000QU0000IKKFRU000QRGKKKKKKKNBBBE070000QRRGKKKKKFRU0000YBOKK
KKKKKKKKNBE0000000030QGKM0000008IKKKKKKKKKKKNBX0000000IKKKKKM0000000IKKK
KKKKKKKKKKNBBBBBE00000QRRU000YBBOKKKKKKKKKKKKM00000ABBOFRRRRRVX0000AOKKK
KKKKKKKKKKKKKKKKNBBE0000000000IKKKKKKKKKKKKKKLX00ABOKKKM0000000000AOKKKK
KKKKKKKKKKKKKKKKKKKM0005000000QRRRRRRRRRRRRRRU000IKKKKKM0005000000QRRGKK
KKKKKKKKKKKKKKKKKKKNBBBBBBBBE0000000000000000000AOKKKKKNBBBBBVVX00000IKK
KKKKKKKKKKKKKKFRRRGKKKKKKKKKM00000000000000YBBBBOKKKKKKKKFRRU0000000AOKK
KKKKKKKKKKKKKFU080QRGKKKKKKKNBBBBBBE00000000QRGKKKKKKKFRRU0000000YVBOKKK
FRRRRRRRRGKKKM000000QGKKKKKKKKKKKKKM000AE00000QRGKKKKKM00000ABE0000IKKKK
M00000000IKKKNBBBX000QRRRRGKKKKKKKKM000QU0000000IKKKFRRVX000QRGE000QGKKK
M00000000IKKKKKKM000000000QGKFRRGKKM000000000YBBOKKKM000000000INE000IKKK
NBBBBBE00IKKKKKKM0000004000QRU00QRGNBE000ABX00IKKKKKM0000YBBBBOKLX00QRGK
KKKKKKM00QRRRRGKNBE000ABE000000000QRRU00AOM000QRRRGKNBE000IKKFRRU00000IK
KKKKKKM0000000QRRRU000IKNE00ABBBE000000AOKLVX00000QGKFU000IKKM00000YBBOK
KKKKKKM000004000000000IKKNBBOKKKM000YBBOKKM00000400QRU0000IKKNBBX000IKKK
KKKKKKNBVY000000000000IKKKKKKKKKNE000QGKKKLVVX000000000000QGKKFU000AOKKK
KKKKKFRU00000000000ABBOKKKKKKKKKKNE000IKKFU0000000ABBBBE000IKFU000AOKKKK
KKKKKM000XVBBBBBBBBOKKKKKKKKKKKKKKM000QRGM000YVVBBOKKFRU00AOFU000AOKKKKK
KKKKKNE0000QRRRGKKKKKKKKKKFRRGKKKKNE0000QGE00000IKKKKM000YJKM00ABOKKKKKK
KKKKKKNBE000000IFRRRRGKKKKM80QGKKKKNE0000QRBE000QRRGFRU000IKNBB0KKKFRRRG
KKKKKKKKM000000QU0000IKKFRU000QRGKKKM000000QM000000QU0000AOKKKMRRRRU080I
KKKKKKKKNBE0000000000QGKM0000000IKKKNBBBE000QVBBE00000000QRRRGM0000000AO
KKKKKKKKKKNBBBBBE00000QRRU000YBBOKKKKKKKM00000IKNBBBE00000000QRVX000ABOK
KKKKKKKKKKKKKKKKNBBE0000000000QRRGKKKKKKNBX000IKKKKKNBBBVVVX0000000AOKKK
KKKKKKKKKKKKKKKKKKKM0005000000000QRRRRRRRE000QOKKKKKFRRU0000000000AOKKKK
KKKKKKKKKKKKKKKKKKKNBBBBBBBBE0000000000000000IKKKKKKM000000500ABBBOKKKKK
KKKKKKKKKKKKKKKKKKKKKKKKKKKKNBBBBBBBBBBBBBBBBOKKKKKKNBBBBBBBBBOKKKKKKKKK