AL1BAAAD1111111111111111111111111111
AL0BAAAD0111110000001111111111111111
AD0BAAAD0111111111000111111111111111
AH0GAAAD0111111110000000001111111111
AH1KAAAD0111111110000004001111111111
11111110011BAEE111100011111111111111
11111110000BAAEL11100011111111111111
11111110000BIEL000000011111001111111
1111111111000J0000000000000011111111
111111110000000000011111100011111111
111111000111111111111111100011111111
111111100001111111111110000011111111
111111111000000111111111100001111111
111111111000000110000111111000111111
111111111110000000000111100000001111
111111111111111110000011117001111111
111111111111111111110000000000111111
111111111111111111110005000000001111
111111111111111111111100000000111111
111111111111111111111111111111111111