RRRKKKKKKKKKKKRRRRRRKKKKKKRRRRRRRRRQ
000QKKKKKKKRRU000000KKKKKU000000000K
0200QRRRKKU0000MKU000KKKU000KKKKU00K
00000000KKKKKKKKN0000R00000KKKKU00KK
NM00BKK00KKKKKKKN000000000KKKKU00KKK
FU00KKK00QRRKKKKKKK000KKKKKKKU000KKK
M00KKKKK0000QKKKKKK007KKKKKU0000KKKK
N00KKKKK00000KKKKKK000KKKKK00KKKKKKK
N00000KKKK000000000000000000KKKKKKKK
00KK00KK00000000000KKKKKK000KKKKKKKK
00KKK00KKKKKKKKKKKKKKKKKK000KKKKKKKK
00YKKK0000KKKKKKKKKKKK00000QRKKKKKKK
K00KKKKKK000000KKKKKKKKKK0000QKKKKKK
K00YKKKKK000000KK0000KKKKBU000AKKKKK
KB00KKKKKKK0000000000KKKKK0000AKKKKK
KE00YMKKKKKKKKKKK00000RRRRU00AKKKKKK
KE000YMKKKKKKKKKKKKK0000000000KKKKKK
KKE000YRRX0000KKKKKKK000000000000KKK
KKNE000000000KKKKKKKKK00000000KKKKKK
KKKKKKKKKKKKKKKKKKKKKNBBBBBBBBOKKKKK