RRRRRRRRRRRRRRRRRRRRRRRKKKKKKKKKRRRRRRRKKKKKKKKK
02000000000000000000000QRKKKKKRU0000000QRRKKKKKK
E00000ABBE0000000ABE00000QRRRU000000000000QKKKKK
KE0000QRRRX000000QKKBE00000000000ABBBE00000QKKKK
KKBE00000000000000QRRU00000000000IKKKM000000IKKK
KKKKBE000000AE00000000000ABBBBBBBKKKKM000000QKKK
KKKKKU00000AKKBBE0000000AKKKKKKKKKKKKKE000000QKK
KKKKM00000AKKKKKKE000000QRRRRRRRRRRRRRU0000000IK
KKKKM00000QRRRRRRU0000000000000000000000000000IK
KKKKKE0000000000000000000000000000000000000000IK
KKKKKU0000000000000ABBBBBBBBBBBBBBE0000000000AKK
KKKKU0000000ABBE000IKKKKKKKKKKKKKKKE000000000QKK
KKKM0000000AKKKM000IKKKKKKKKKKKKKKKKE000000000IK
KKKM0000000IKKKM000QRRRRRKKKKKKKKKKKM000000000IK
KKKU0000000IKKRU000000000QKKKKKKKKKKKE000000ABKK
KKM0000000AKKU000000000000QRRKKKKKKKKU000000IKKK
KKM0000000QRU0000ABBE00000000IKKKKKRU0000000QRKK
KKU0000000000000AKKKKBE000000QRRRRU00000000000IK
KM000000000000ABKKKKKKM00000000000000000ABBE00QK
KM000000ABBBBBKKKKKKKKKBE000000000000000IKKM000I
KM00000AKKKKKKKKKKKKKKKKU000000ABBBBBBBBKKKM000I
KU00000IKKKKKKKKKKKKKKKU000000AKKKKKKKKKKKKM000I
M00000AKKKKKKKKKRRRRRRU000000AKKKKKKKKKKKKKM00AK
M00000QRRRRRRRRU0000000000000QRRRRRRRRKKKKKM00IK
U0000000000000000000000000000000000000QRRKKM000I
00000000000000000ABBBBBBBBBE0000000000070QRU000I
0000ABBBE00000000QRRRRRRRRRRX000000000000000000I
0000IKKKKE000000000000000000000000ABBBBE0000000I
E00AKKKKKKE0000000000000000ABBBBBBKKKKKKBBE0000I
KBBKKKKKKKKBBBBBBBBBBBBBBBBKKKKKKKKKKKKKKKKBBBBK