11111111111111111111111
111GEEEEAAAEEEEAAEE1111
000KEEEEEEEEEALJKEE1111
0200KEEEIEIEIAD0BEA1111
0000BEAEEEEAAAHFGEA1111
1110BEAAEEEEEEAAAAA1111
11100KEEEEIEAAEAAEA1111
11FFFGAAAEEEAEEEEAA1111
11EEAAEEAELJJJJKAAE1111
11JJKEEEEED00000JKE1111
11100JKEEL0000FFF011111
111111BEL11111AEE111111
11111111111111111111111
