11111111111111111111111
111GEEEEEEEEEEEL1111111
000KEEEEEEEEEAL00011111
020AKEEEIEIEIL000011111
0000BEAEEEEEL0000011111
1110BEAAEEEEDFFBCDF1111
11100KEEEEIEAAEAAEA1111
11FFFGAAAEEEAEEEEAA1111
11EEAAEEAELJJJJKAAE1111
11JJKEEEEED00000JKE1111
11100JKEEL0000FFF011111
111111BEL11111AEE111111
11111111111111111111111
