11111111111111111111111
AAAAAEEEEEEEEEEEL111111
EEEEEEEEEEEEEAEL0011111
EAEAAEEEAAEAAAEH0011111
EEEAAEAEEEEEEEAAD011111
EEAEAEAAEAEAAAELFFF1111
11JJJKEEEEIEAALBEEA1111
11FFFGAAAEEEAEDBEAA1111
11EEAAEEAEAAAL00KAE1111
11JJKEEEEEEALFFFGEE1111
11100JJJJJJJGAEEEAA1111
11111111111GA1111111111
11111111111111111111111
