11111111111111111111111
AAEEEEEAAAEEEEEAAAA1111
AAEEEIEEEEEEEAALKAA1111
JKAAEAEEAEAEAAL00KA1111
00JJKEAEEEEEAL000BA1111
1110BEAAEEEEAHFFFGA1111
11100KEEEEIEAAEAAEA1111
11100GAAAEEEAEEEEAA1111
1110GAEEAELJJJJKAAE1111
11JGAEEEEED00000JKE1111
11AAIEAEEL00FFFFFGE1111
11AEEAAEA000EEAEEAE1111
11111111111111111111111
