11111111111111111111111
111GEEEEEEEEEEEL1111111
000KEEEEEEEEEAL00011111
0200KEEEAAEAAAE00011111
0000BEAEEEEEEEAA0011111
1110BEAAEEEEAAEEADF1111
11100KEEEEIEAAEAAEA1111
11FFFGAAAEEEAEEEEAA1111
11EEAAEEAEAAAEEAAAE1111
11JJKEEEEEEEEAAIJKE1111
11100JKEEL0000FFF011111
111111BEL11111AEE111111
11111111111111111111111
