11111111111111111111111
AAEEEEEAAAEEEEEAAAA1111
EAEEEAEEEEEEEAAAAAA1111
EAEAEAEEAEAEAALJJKA1111
AAEEEELJJJJJJJ000BA1111
11JJJJFFFFFF00000GA1111
11100BEEEEIEHFFFGEA1111
11100GAAAEEEAEEEIAA1111
1110GAEEAELJJJJKAIE1111
11JGAEEEEED00000JKE1111
11AAIEAEEL00FFFFFGE1111
11AEEAAEA000EEAEEAE1111
11111111111111111111111
