11111111111111111111111
11111111111GEEEL1111111
00000000000KEAL00011111
02000000000BAL000011111
000000000F0GL0000011111
11100000BECED0000011111
11100000BEEED0000011111
11100000BEEID0000011111
111000000JJJ00000011111
11100000000000000011111
11100000000000000011111
11111111111111111111111
11111111111111111111111
