KKKKKKKKKKKKKKKKKKKKKKK
RRRRRRRRRRRRRRRRRRGKKKK
000000000000000000IKKKK
020000000000000000IKKKK
000000000000000000IKKKK
BBE000000000000000IKKKK
KKM000000070000000IKKKK
KKM000000000000000IKKKK
KKM000000000000000IKKKK
KKM000000000000000IKKKK
KKM000000000000000IKKKK
KKNBBBBBBBBBBBBBBBOKKKK
KKKKKKKKKKKKKKKKKKKKKKK
