11111111111111111111111
111GEEEEEEEEEEEL1111111
000KEEEEEEEEEAL00011111
0200KEEEIEIEIL000011111
00000JKEEEEEL0000011111
11100000BEEED0000011111
11100000BEIED0000011111
11FFFFFFGEEED0000011111
11EEEEEEEELJ00000011111
11JJKEEEEED000000011111
11100JKEEL0000000011111
111111BEL11111111111111
11111111111111111111111
