11111111111111111111111
AEEAAAEEEEEEEEEAEEE1111
EAIAEEEEEEEEEAELJJJ1111
AAAEEEEEAAEAAAED0011111
EEAAAIAEEEEEEEAD0011111
11EAEEAAEEEEAAL00011111
111EEEEEEEIEAED00011111
11EEEEAAAEEEAED00011111
11EEAAEEAEAEAL000011111
11AAAALJJJJJJ000FGE1111
11JJJJ00000000FGAAE1111
11111111111111AEEAA1111
11111111111111111111111
