11111111111111111111111
11111111111111111111111
00000000FFFFFFF00011111
02000FFGAAEAAAEH0011111
0000BEAEEEEEEEAAHF11111
1110BEAAEEEEAAEEAEE1111
11100KEEEEIEAAEAAEA1111
11FFFGAAAEEEAEEEEAA1111
11EEAAEEAEAAAEEAAAE1111
11JJKEEEEEEEEAAIAEE1111
11100JKEEEEEAIAEAEE1111
111111AAAEEEEAEAEAA1111
11111111111111111111111
